1111111111
1400000041
1000300001
1000000001
1003000001
1001111031
1201400001
1001000001
1111111111