1111111111
1002011101
1030101041
1001001001
1000001001
1000000001
1001001001
1030101001
1000011141
1111111111