222222222222
200000000002
203020320302
202020202202
201000000002
202024242202
203020320302
202000000002
204343434402
222222222222
