222222222
200000002
203020302
202242202
203010302
202000002
201343402
222222222
