222222222222
200040400002
203023020002
202000202202
201000000002
202024222202
203020040302
202000300002
204343000402
222222222222